level2
#######
#A    #
#@@@@@#
#ooooo#
#     #
#######